F 234,56,254


NO ./sprites/wall1_500.png
SO ./sprites/wall2_500.png
WE ./sprites/wall3_500.png
EA ./sprites/wall4_500.png

C 45, 34, 54

             a11111
    1111111   10001
    1000001   10001
    10000W011110001
    100000000000001
    111001111111111