F 234,56,254


NO ./sprites/wall1.png
SO ./sprites/wall2.png
WE ./sprites/wall3.png
EA ./sprites/wall4.png

C 45, 34, 54

    1111111111111
    1000000000001
    10S0111111001
    10001    1001
    1000111111001
    1000000000001
    1111111111111