F 234,56,254


NO ./sprites/wall1_500.png
SO ./sprites/wall2_500.png
WE ./sprites/wall3_500.png
EA ./sprites/wall4_500.png

C 45, 34, 54

    1111111111111
    1000000000001
    10S0111111001
    10001    1001
    1000110111001
    1000000000001
    1111111111111