F 234,56,254


NO texture
SO texture
WE texture

EA     texture

C 45, 34, 54

    1111111111111
    1000000000001
    10S0111111001
    10001    1001     0
    1000111111001
    1000000000001
    1111111111111