NO ./sprites/wall1.png
SO ./sprites/wall2.png
WE ./sprites/wall3.png
EA ./sprites/wall4.png

F 220,100,30
C 225,30,10

        1111111111111111111111111
        100000000011000000000000111111111111111111111111111111111
        101100000111000000000000000000000000000000000000000000001
        100100000000000000000000000000000000000000000000000000001
11111111101100000111000000000000000000000000000000000000000000001
10000000001100000111011111111111100000000000000000000000000000001111111111
11110111111111011100000010001000000000000000000000000000000000000000000001
11110111111111011101010010001000000000000000000000000000000000000000000001
11000000110101011100000000000000000000000000000000000000000000000E00000001
10000000000000000000000000000000000000000000000000000000000000000000000001
10000000000000001101010010001000000000000000000000000000000000000000000001
1100000111010101 11101111000111000000000000000000000000000000000000000000011
11110111 1110101 101111010001000000000000000000000000000000000000000000001
11111111 1111111 111111111111000000000000000000000000000000000000000000001
                             111111111111111111111111111111111111111111111
