F 0,0,0


NO ./sprites/wall1_500.png
SO ./sprites/wall2_500.png
WE ./sprites/wall3_500.png
EA ./sprites/wall4_500.png

C 45, 34, 54

    1111111
    1000001
    10000001111
    10000000001
    1111111111111