NO ./sprites/wall1_500.png
SO ./sprites/wall2_500.png
WE ./sprites/wall3_500.png
EA ./sprites/wall4_500.png

F 220,100,30
C 25,30,10

        1111111111111111111111111
        1000000000110000000000001
        1011000001110000000000001                              1
        1001000000000000000000001                             101
111111111011000001110000000000001                              1
100000000011000001110111111111111
11110111111111011100000010001
11110111111111011101010010001
11000000110101011100000010001
10000000000000001100000010001
10000000000000001101010010001
1100000111010101 111011110E0111
11110111 1110101 101111010001
11111111 1111111 111111111111