F 234,56,254


NO texture
SO texture
WE texture

EA     texture

C 45, 34, 54

    1111111
    1000001
    10000W01101
    10000000001
    1111111111111