F 0,0,0


NO ./sprites/wall1.png
SO ./sprites/wall2.png
WE ./sprites/wall3.png
EA ./sprites/wall4.png

C 45, 34, 54

    1111111
    1000001
    10E00001111
    10000W00001
    1111111111111