NO ./sprites/wall1_500.png
SO ./sprites/wall2_500.png
WE ./sprites/wall3_500.png
EA ./sprites/wall4_500.png

F 220,100,30
C 5,30,10

        1111111111111111111111111
        100000000011000000000000111111111111111111111111111111111
        101100000111000000000000000000000000001010000000000000001
        10010000000000000000000000111111110000000000000000000001
111111111011000001110000000000000000000001111111111110000000000011
10000000001100000111011111111111100000000000000000010010000000001111111111
11110111111111011100000010001000000000000000000000000000000000001111111111111
1111011111111101110101001000100000000000111111111111000000000000110001
110000001101010111000000000000011000000000000000000000100000001000111111111111
10000000000000000000000000W0000000001111111111110001010000000000000000001
1000000000000000110101001000100000000000000000000000000001111111100000000111
1100000111010101 11101111000111000000000111111111111000000000000000000000011
11110111 1110101 1011110100010000000000000000010000000011111111000000000001
11111111 1111111 111111111111000000000000000001000000000000000000000000001
                             111111111111111111111111111111111111111111111
