NO ./sprites/wall1.png
SO ./sprites/wall2.png
WE ./sprites/wall3.png
EA ./sprites/wall4.png

F 220,100,30
C 225,30,10

11111111111111
10000000000001
10111111111101
10100000100001
10001110111001
10100010100001
10101110101111
101000001000001
101111111111E1
100000000000001
111111111111111
